0000000000000000000000000000000000000000000000000000000000000000000000000000000000000000000000000000000
0000000000000000000000000000000000000000000000000000000000000000000000000000000000000000000000000000000
0000000000000000000000000000000000000000000000000000000000000000000000000000000000000000000000000000000
0000000000000000000000000000000000000000000000000000000000000000000000000000000000000000000000000000000
0000000000000000000001000000000000000000000000000000000000000000000000000000000010000000000000000000000
0000000000000000000000000000000000000000000000000000000000000000000000000000000000000000000000000000000
0000000000000000000000000000000000000000000000000000000000000000000000000000000000000000000000000000000
00000000000000000000GGGGGGGGGG00000000000000000000000000000000000000000000000GGGGGGGGG00000000000000000
0000000000000000GGGGGDDDDDDDDGGGG0000000000000000000000000000000000000000000GGDDDDDDDGG0000000000000000
000000000000GGGGGDDDDDDDDDDDDDDDGGGG0000000000000000000000000000000000000000000000000000000000000000000
000000000GGGGDDDDDDDDDDDDDDDDDDDDDDGGGG0000000000000000000000000000000000000000000000000000000000000000
000000GGGGDDDDDDDDDD0000000000DDDDDDDDGG000000000000000000000000000000000000000000000000000000000000000
000GGGGDDDDDDDD0000000000000000000DDDDDDGG0000000000000000000000000000000000000000000000000000000000000
GGGGDD00000000000000000000000000000000DDDGG000000000000000000000000000000000000000000000000000000000000
00000000000000000000000000000000000000000000000000000000000000000000GGGGG000000000000000000000000000000
000000000000000000000000000000000000000000000000000000000GGGGGGGGGGGGDDDGGGGG00000000000000000000000000
00000000000000000000000000000000000000000000000000000000GGDDDDDDDDDDDDDDDDDDGGGG00000000000000000000000
00000000000000000000GGGGGGGG000000000000000000000000GGGGGDDDDDDDDDDDDDDDDDDDDDDGGG000000000000000000000
0000000000000000000GGDDDDDDGG0000000000000000000GGGGGDDDDDD00000000000000000000DDGGG0000000000000000000
000000000000000000000000000000000000000000000GGGGDDDD0000000000000000000000000000DDGG000000000000000000
00000000000000000000000000000000000000000GGGGGDD00000000000000000000000000000000000DGGG0000000000000000
0000000000000000000000000000000000000GGGGGDD00000000000000000000000000000000000000000DGGG00000000000000
000000000000000000000000000000000000GGDD00000000000000000000000000000000000000000000000DGGG000000000000
0000000000000000000000000000000000000000000000000000000000000000000000000000000000000000000000000000000
GGGGGGGGGGGGGGGGGGGGGGGGGGGGGGGGGGGGGGGGGGGGGGGGGGGGGGGGGGGGGGGGGGGGGGGGGGGGGGGGGGGGGGGGGGGGGGGGGGGGGGG
DDDDDDDDDDDDDDDDDDDDDDDDDDDDDDDDDDDDDDDDDDDDDDDDDDDDDDDDDDDDDDDDDDDDDDDDDDDDDDDDDDDDDDDDDDDDDDDDDDDDDDD
DDDDDDDDDDDDDDDDDDDDDDDDDDDDDDDDDDDDDDDDDDDDDDDDDDDDDDDDDDDDDDDDDDDDDDDDDDDDDDDDDDDDDDDDDDDDDDDDDDDDDDD